%%%%%%%
%o    %
%   o %
% oGo %
%   o %
%P  o.%
%%%%%%%
