%%%%%%
%   o%
%o o %
%  . %
%P G %
%%%%%%
