%%%%%%
%    %
%    %
%.   %
%PG  %
%%%%%%
