%%%%%%%%%%%%%%
%G           %
%           o%
%  P        o%
%          .o%
%        oooo%
%%%%%%%%%%%%%%
